67,66,13,13,13,83,84,85,13,13,68,13,65,13,67,13,13,13,13,13,13,13,13,13,13,13,13,13,13,13,13,13,13,13,13,13,13,13,13,13,13,13
13,66,64,13,13,99,100,101,13,65,42,13,13,13,13,67,13,13,13,13,13,13,13,13,13,13,13,13,13,13,13,13,13,13,13,13,13,13,13,13,13,13
68,13,13,13,13,115,116,117,13,13,67,13,64,13,13,13,13,13,67,13,13,13,13,13,13,13,13,13,13,13,13,13,13,13,13,13,13,13,13,13,13,13
13,13,67,13,66,13,13,13,67,13,13,13,13,13,13,13,13,13,13,13,13,13,13,13,13,13,13,13,13,13,13,13,13,13,13,13,13,13,13,13,13,13
15,13,13,13,13,13,13,13,13,13,64,13,13,13,13,13,13,13,13,13,13,13,13,13,13,13,13,13,13,13,13,13,13,13,13,13,13,13,13,13,13,13
31,29,11,13,13,67,13,13,66,13,13,13,13,13,13,13,13,64,13,13,13,13,13,13,13,13,13,13,13,13,13,13,13,13,13,13,13,13,13,13,13,13
2,2,2,4,65,13,13,64,13,68,13,13,13,13,13,13,13,13,13,13,13,13,13,13,13,13,13,13,13,13,13,13,13,13,13,13,13,13,13,13,13,13
69,69,72,19,13,13,13,13,13,13,13,13,13,13,13,13,13,13,13,13,13,13,13,13,13,13,13,13,13,13,13,13,13,13,13,13,13,13,13,13,13,13
69,70,71,17,66,13,67,13,13,13,13,13,13,13,9,10,13,13,13,64,13,13,13,13,13,13,13,13,13,13,13,13,13,13,13,13,13,13,13,13,13,13
69,71,71,17,13,13,66,13,67,13,13,13,33,32,33,33,13,13,13,13,13,13,13,13,13,13,13,13,13,13,13,13,13,13,13,13,13,13,13,13,13,13
70,69,69,17,13,13,13,65,13,13,13,13,12,73,73,13,13,13,13,13,13,13,13,13,13,13,13,13,13,13,13,13,13,13,13,13,13,13,13,13,13,13
71,70,69,19,120,67,13,13,13,13,13,13,28,73,73,13,13,13,13,7,8,13,13,13,13,13,13,13,13,13,13,13,13,13,13,13,13,13,13,13,13,13
69,69,69,17,13,13,13,13,13,13,50,51,52,73,73,13,13,13,0,2,2,13,13,13,13,13,13,13,13,13,13,13,13,13,13,13,13,13,13,13,13,13
70,69,71,17,13,34,35,35,36,13,60,73,13,73,73,13,13,13,16,70,69,13,13,13,13,13,13,13,13,13,13,13,13,13,13,13,13,13,13,13,13,13
69,69,69,17,13,13,73,73,13,13,60,73,13,73,73,13,13,13,16,72,70,13,13,13,13,13,13,13,13,13,13,13,13,13,13,13,13,13,13,13,13,13
72,70,69,19,13,13,73,73,13,13,60,73,13,73,73,13,13,13,18,69,69,13,13,13,13,13,13,13,13,13,13,13,13,13,13,13,13,13,13,13,13,13