67,104,58,13,80,81,82,13,65,13,13,13,13,13,13,13,13,13,13,13,13,13,13,13,13,13,13,13,13,13,13,13,13,13,13,13,13,13,13,13,13,13
13,64,13,13,96,97,98,13,13,68,13,13,13,13,13,13,67,64,13,68,13,13,13,13,13,13,13,13,13,13,13,13,13,13,13,13,13,13,13,13,13,13
67,13,104,64,112,113,114,104,13,13,13,13,67,66,13,13,13,13,13,13,13,13,67,13,13,13,13,13,13,13,13,13,13,13,13,13,13,13,13,13,13,13
13,13,68,13,13,13,13,13,13,13,13,13,13,67,13,13,13,13,13,13,13,13,13,13,13,13,13,13,13,13,13,13,13,13,13,13,13,13,13,13,13,13
13,13,13,13,13,13,13,13,65,13,13,13,13,64,13,13,60,13,13,13,13,13,13,13,13,13,13,13,13,13,13,13,13,13,13,13,13,13,13,13,13,13
15,13,13,12,13,13,13,13,13,13,13,13,13,13,13,13,13,13,13,13,64,13,13,13,13,13,13,13,13,13,13,13,13,13,13,13,13,13,13,13,13,13
31,13,7,8,29,13,13,13,13,13,13,13,13,13,13,13,13,13,13,13,13,13,13,13,13,13,13,13,13,13,13,13,13,13,13,13,13,13,13,13,13,13
50,3,1,2,35,51,52,13,13,13,12,13,13,13,13,13,13,13,13,13,13,13,13,13,13,13,13,13,13,13,13,13,13,13,13,13,13,13,13,13,13,13
13,76,71,79,93,104,68,65,13,13,28,11,13,13,13,13,13,13,13,13,120,13,13,13,13,13,13,13,13,13,13,13,13,13,13,13,13,13,13,13,13,13
13,76,13,77,13,66,67,13,13,50,51,3,1,2,4,13,13,13,13,13,120,13,13,13,13,13,13,13,13,13,13,13,13,13,13,13,13,13,13,13,13,13
13,76,79,77,13,13,13,64,13,13,18,13,13,79,19,13,13,50,51,48,51,52,13,13,13,13,13,13,13,13,13,13,13,13,13,13,13,13,13,13,13,13
13,76,69,77,13,104,27,13,13,13,18,13,6,21,22,13,13,104,13,74,13,13,13,13,13,13,13,13,13,13,13,13,13,13,13,13,13,13,13,13,13,13
13,76,71,34,2,3,3,52,13,13,18,13,19,77,13,64,13,66,13,74,13,68,13,13,13,13,13,13,13,13,13,13,13,13,13,13,13,13,13,13,13,13
13,92,94,94,16,72,19,13,13,104,18,13,17,93,13,13,13,13,13,74,13,13,13,13,13,13,13,13,13,13,13,13,13,13,13,13,13,13,13,13,13,13
13,65,13,13,18,13,17,13,13,13,16,13,17,13,13,13,67,13,13,74,13,13,13,13,13,13,13,13,13,13,13,13,13,13,13,13,13,13,13,13,13,13
66,13,13,13,16,78,17,13,13,13,18,13,17,13,13,13,13,13,13,74,13,13,13,13,13,13,13,13,13,13,13,13,13,13,13,13,13,13,13,13,13,13